11111111
11CP1E11
1C01C1E1
11111111