1111111111111111111111111111111111111111
1P00000000000000000000000000000000000011
1000011110001111111011111110111111111011
100011C11000111111101111111011C000C1101
1001100110000000C1100000C11000000001101
101100011000111111101111111000000001101
100000011000111111101111111000000001101
1000000110000000C1100000C11000000001101
1000001111001111111011111110000000C1101
100001111110111111101111111000000001101
1000000000000000000000E0000000000000001
111111111111111111111111111111111111111
