11111111111
11CP0100E11
11111111111