11111111111
11CP0000E11
11111111111